19,11
144,102
72,32
72,2
78,32
121,17
44,46
149,93
17,19
39,39
110111101111011110a1111011101011101101101111011110110111122022121002021220100122122111221111111011111111110010111111a0010111111011110111111101111111101111110a11
011110111001111111a1101001101101011110101110010111111101112012212120121102221222220021200111111111101111110111101101a1111011101111111011101101111101011111111a11
101111101101011101a0110111111111111111111101011111011111121020102202221211110101222111101110101110001110112221222222b2010222122222111202001111001111101111111a10
111111011110110001a1111011111101100111111111011001111101102121211220221211111112211012111111111111111111110222211221a2122221202221122120011111100111011001111a11
111122122201020211b1120111211210111110001101101111111110121112202112122201011111212212110010111111101110112011212101a2212001120001122112010101111101110111111a11
111021122122021110b1010120000211210101111101111100111111001221201122122210012201221122021111110101110011111211122012a2000121211110120211211011111111011001111a11
101222011022100210b2021122112210111111010111001111111111121012220220022212202021101022201001111111110011012222010222b0112121212021111210201111011111111111101a11
111101001021202211b1212112201212111001110111111111110001111121121110211221121122022000211111111111111111112220220120b1011122012021120220211111111101011110111a11
112210211210121111b2202121202211010111111011111101111111112221101002002221222102110211121011010110110101110210211001a2211122220012222200211011001111101001111a11
100112021122002122a2122110110201110111111110101111111010111210120221110211111012201111011010111111100110112122220222b0022221012220222101010111111111111111111a11
112111112111021221a2202110201010211111111110111111111111121221222210122100012222220210111111111101111111102212121021b1022102111222201121201110110111101111111a11
012121101121210211bs021202021112211110111011011111110111022221100121202222012112221221101011111111111111111201111120b1122202111201201222211101110111101111011a11
012222122210200202a1012121102021111111111101111110011110120120111101210220001000202122221111110110111111010221221200b1112211202102011222210001011000110111111a11
111222222121211212b2221122112121111111111101111100011111112101122022010010101001111212111111111001111111111211211220b1022101211000111212010111110111011111111a11
101212101101122121a0122120102001111111111011111111111111101122122112010220111021012111121111110111100011112121211202a2202110002221210221111110111101111111011a00
002120122002211102b1100211011110101101100110111011111110121120121220221022220111121221201101111101111111112111201121a2010221012210121021111111110111011111111a11
012012212211211101b0121201102101201111001111111111111111101210022211220212020122221210021110111111001011100212102212a1222121211121201222211111001111111011111a11
112211121200102001a0222212210210211111111110101101110111102120122202220112222222222222010021221111111111011122201021b0112222012002220110211111111011101011011a01
102112210001210120a1101020112121101011010111111111011100121222222122222011202201002211220220111011101111100121211102b0210202111012121001111000111110111011111a11
112100220211121122a2211122122121210111011011001110111011122212121011222022122222201021221201101111110111010111212021b2110222102111212111010011111011111110111a10
010121120200201212b2212111122221111101111011111111101111021211212012120202220222212122020222111111110111112020110022a0111122001112001212111011011010011111111a11
111211110122102101b2022201122211111011111111100011011110122022202100002111212222002212022112011111011101012101121110b1202222022020022112211011011111111011111a11
110010200121211010a2001221110221011111111111111011111111111012021200220122021201222122222121021010011001111112102102a1012221121221012211211111111011111101111a11
112021121122211122a1122112202011111110110010110110110111000122121222222102222010202012000110111011110010112121222100b1212112221120122112110101111011001111010a11
112122200112201100a0211222200202112202112202122111111111111112020101222221221101122200022210201111011011110101201121a0222012221201112210011001001011101011111a11
101122120101121211b1212002212220012002222200112212202021112111222221222202222222220022011212221111100101100110121221a1212221102011212200211111101111011111111a10
101111111112221120a2122221222212112112022012222012021100111211102022022222222012200221221221020111101011111220111121b0222112100022211120211011110001111110111a10
012122020021212201a1210222102212211122211100012201221101102201112002212201122221202101220112111011101101000012212100b1200101212202220121211111101011011011111a11
112102121111122222a0021221122020210210122112101120202221112122212011210221122122120022222200221101111101112112111102a2111201210122220112211111110111110111111a00
111212122102221222a1111022112121212112110011102121111121122200222121202022201212200221222122220001111101112110001111a1101110202200112222211011011111011000100a11
101122122220120220a0112021200221110122122122120120222111112210200022212222022102212120201011211110111011101111112001a1220212101221121222100010111001111111101a11
110112122212112121b1112122122020222220210022212022222222100202112212122222222001202122101121221111111111001222212121b0121012211001111222111111110001110111111a11
100022011111121210a2120202102201100022220021122222222220121212021210020210220200221122201211201111111110112211011122b1201001202222201211011111011111010111101a01
111022221220011122b0210112202020222202121202001121222102000022221200122122220211012202022211221111111111110001111111a0111100011101101110111111011110011110101a10
002211211121121200b0221210202222202202021202122202020222202210022021122210020212112022021110111111011111111011101111a1111101111011111011101111111011111111011a11
010111111110111111a1011122120222221220021202121222220222120101221010001122120220212201212110120111111011111001001111a1011110111110111111111011011110110110100a10
111000000001111111a1111111012022222222202022102220021120222002002022200120022011212002200101220011111111111111110111a1111111110111111101111101111111111101011a11
111111111111111101a1111102122021122021222222022221212222000111002222100022022122222221222111201100101011111111110110a0110111111010111111011010111111011011111a11
001111101011111010a1000021112202220212021001212210222221212101122220202222122220022222222111221111101110100111111011a1110110011101010110111101001111111111101a11
111111101011101111a1011121002200212020212210002210022111111122120221112222222222211222200222211010011101111101111011a1110111010011111110110110111111100101101a11
011110111111110111a1001012202202200220212001212122222221002022220022220111212212000222221011211011111011110111111111a0011101101110110111111101111111100111011a11
100111100111111110a1110022220001021222222220120222022021122111202220012222202202222202201111021111011101110111110101a1111111111011100111101101011100111101111a10
011111011110110111a1111022102022202212222221202221222212221122122112121220221202001222011110021101110110001011011111a1111111111111111111011111111111110111111a11
111110111111101111a1010010111120220222020002022121222201120212211202222101120222121112201222221111101101111110111111a0111101111011111110110110111111101111110a10
011011110111011011a1111111222211122212020222222021202202222211021120222212202222020022221110110111110011001111111111a0100011111111011110111101101100111011111a11
111010101111111101a1101110121221012222201000222222222201102211121112202211122202221022201202221101111101111111111110a1111111111011111001011111111111111111110a11
111110111111111111a1111112020100222222222002002222210022222220222022212202220122122110222212210111111111100101110111a0111111111011101111111011111111111011111a10
101101011010011101a1111112201122201122220202210222202222002211222221121120202212202202201101221101111111111001111111a1111111110111011111110011111100010110111a10
111111111111111111a1111102111022222201210222220222002111112111011101111010011111110110111111111111101101110111111111a1111101011111001110111111101011101101101a11
010010111110011001a1110121012222222112222212221202122201222010111011101111100101101110111111111101101100111110111101a1111111011101111100111100111111001010011a11
110100110110101011a1111121102211222202000201112220220222112211101111101111111110110111111111011111001101111110110001a0111111101111010111111111110110001101111a11
111111110110111101a1111102102102122220201101100110202221220111111110111111111010110111111101011111111111110111111001a1110110110111111011010011111111110111100a11
101110110011001100a0100022201201222012202112221220212120122111011001100111111111111011111111101111101111111011110111a1111011110111111010111111001111101111111a01
111110110110111111a1010122201222222022222222221221211221111011101111111001111111010111110111111111011001000111010101a1101111111100010101011111111011011100111a11
011111111111111111a0111122211122222122222121012222102221111011111111111001111011101111111101111111111111111101001010a1111101011111110111111111011111111001111a11
101101010010111110a0111111110122101122121011001120201212122111111011110111110111111011111110101101111010101011101101a0111100101101111111110111011111101110111a11
110110101111010111a1110111111010212210021112002022220102120011110111110111111111111110111110111111111111101111011101a1110111111111111111111000111111111011111a01
111101111100111111a1011111101101122120101112121211022002220211100100111011111111111111110101111111011111111110111011a1111011111110111110111011111111110110111a11
111001111000011111a1110110100212101011202211222102022101011011111111011111111101101011110111111111101111110011111101a1110111111010101111011011111011111110110a11
111011111111111111a1101110111021121112222221102122021201122101111111011110111111001110111111101111010111101101001011a0111111111110111101011111101111101101111a11
111011011011011011a1101111111201000012212111102011120202221211100111110010101101111011111111111001010111111001111110a1011111011111111110011111111110011011110a00
011111111111101111a1111100101221112110111212122101211121101111010110011111010111101111001011111100110111111100101111a0111100111111111001111101111111111101111a11
101111111110111111a1111111011110111001111111111111101110100011111001101100110111101111101111111111111011101110111110a0111111111011101111011101010111111111111a01
111011110011111110a1101110110111111111111111111111001011111111111111111111101001111111110011111111111111111001111011a1001111011111111101111111110110111111101a01
111101110000101111a1111101001011011111111110000111111010111011101011111110011101010110101111111010001111010111011111a1101101110111110110010111101110110101111a11
111111111111111011a1101111111111101110111011111110110110110111111101111010101111111011100011111111101110011111010011a0111111100010111011111110101010001111001a11
101111111111110111a1111111101111101011001111111111111011111101001111101011110001010011101011110111101111111101011011a0011111111111110010111010110100111111100a01
111111011011111101a1111110111111111100111111101111111111011110011100111011001111110111111011111111011111110111111101a1111011011111111111111111110101111010101a10
111101111111111111a1111111111010011100111100011110111111111011111111001111111110111011001110101001101111111111011111a0110111111111111101110001011110111011111a01
111001111111011111a1101011111111111000111111101111001110111111111111011101111110110011111110110100111110111110011111a1111110111100111111111111111011111101101a01
101111101111111111a0111110111111111111101111010111101111111111101110101101011110001011101011110100101110111001111111a1101011111011111011111111111111111011110a11
111011111111001011a1110011101101101111110110011101111110111000110111110110111010101111101101100101111111011111011111a1111010101111111001100110100110111101110a11
111101111101110111a1111111111011011110111101011111110111101101101111111011011111010111101110011110110101010001111001a1111111001111111110111111101011000111111a00
111111111011100111a1110111100011111101001111001111111111110011111111111111011111111111111100111111111111111001111111a1111111111111111111011110010110111111011a10
101111101111111111a0111111110111101011111101111111010011111110111111111011011011111111111111101011111111111011111100a0111110011000111011111111111111111010111a11
101101111110111101a1111011111111111011111111101111111011101111101001011111000101111111110111110101111111111011111011a1111111010111111111111111111110111101010a11
111110111011111111a1111101111011111111111111010111111110011111111110111101111110001111111111011010111111011101011100a1111111111010111011011011100111111111110a11
111011111100111111a1111100111111111110111111101100111111111110101101011111010110110001110111111000101011100100111011a1111010001011111100111101111111111101111a01
111101111111111111a1111011111111010001011111110111010111101111111110110011110111111111111111111101111110111011111111a0010001110111010012100212112212022210020b01
111111101011111111a101111110101aaaaaaaaaaaaaaaaaaaaa1111111101111111111111011101110111010011010111111110101011011111a1111111111111001111112221210200222211111a21
101011111110111111a111101011111a1110111011101110111a1011001111110111111110111001111010110111101111011011111001110101a1110111111011111112122122102111111221201a01
101111111001011011a111111110011a1101011111111111111a1111111111111111111111110101111101101110110111110111110111101111a1110111100101011022021010012211222211121a21
111101001100111111a011111101111a1111110111011111111a1111111110111011111111111110111010111111111111011110011111101111a1111111001101111011121021202112211222122b21
111110101101101111a101101111111a1101001111111111111a1101111111111001110111101110101101111111010110111111110110011111a1111110101111111101222012211201010221022b11
110111110111111111a100011001110a0111110111100111101a0011110011111011111101111110101111111011011011111101111001111111a1111111111111111101222022222211102012222a20
110011111111110111a001011111100a1101111110111111110a1111111111111111111010111111111101011100101111010111111111111111a1111111111110111121122202001202221121011a10
101111110111111111a111110101111a0110101111100111111a1011111111111111111111011111101011111111001001011011101110011111a1110110110111100102022121212112222021211b20
101011100011111110a111111111111a0101111111111100011a1111111111110000111111101111111011111111111111101111111110110111a1011101011111111010122020220010121021122b21
110010111111111111a101111111111a1001111101111111001a0011111110111111101101011011111111111111101011111101111111111011a1111111110111111122021210112112212112001a21
110101011011111111a100110111111a1110101111101110110a1111101111111111011111111111111111111111111111011111111111100111a1001111100110111112112002211022220122120a21
111111111011111111a111111111101a0101010111111111111a0111011011110110110001111111110111011111111111111110111011110111a0111011101101111111220212101112211211120a11
111111001111111111a110101111101a1111101010101111011a1011111111011111111111101110000111101111011001111110111101111110a0101111101110000122211210220221102220211a21
110111111010111111a111111111101a1110110011101111011a1111011110010100111111010111001110111100111100100110101111111101a1111101110111111112212111120201011211220a11
110111110111111101a001110110111a1111111000111111101a0101001011111110101111111100101111111101110111100111111111111111a1111101111011111120002212201111202222120b11
111011101111111111a111111010101a1111101011111111111a0101111101011101110111111111110111011110111001011100110111111111a1111110101100100020122221201121122222120b00
110111111101111011a100011110011a1111111011111111001a1100111110111111111100101011000101111111101111111111111111100111a1110110111111110102210211221022222001111b21
111111011010101111a101111011111a1111111001011111111a1111111111111011111011110111111101101110100110111011001110011111a1110110111001111012212102220111212111211a01
110111111011101111a101110111011a1111111111111110111a0111000110111011110111111000111111110110111111100111011111111000a1011001111101111121111200022221112220221b11
111010111111110100a111011111011a0101111111111111101a1010111010111111001111110111011111011110110111111111011111111110a1010100111011101101220012101111210100011b01
101101111111111111a111111001111a1110110111011111110aaaaaaaaaaaaaaaaaaaaaaaaaaaaaaaaaaaaaaaaa100111100011110110011111a1111010111111110110202202101111122222221a20
110011111111011111a111111111111a01111101111101101011111111111110111101111110111111111110100a110110111101101101111110a0101110101111111111021121121111112211020b21
111111111011011101a110111011011a11111111111100100011111111011111011111101110100110111111111a111111011111111111111010a1111111111111101112222120010021220220121b11
110111111011111101a111111111111a11111100101111011110111111111111110011111111001110111111110a110011011111111111011011a111111111111110112122211220e122112221202b21
111100111110101111a001101111111a11111110111111011111111111111110100111111101010111101101111a101111111111111111001101a1101101011111111122212101020212200122200a21
101011111101101111a111101111111a11110001011110110111111100111110011111110111111111101011111a111110111110110011111111a1111111111001111102010121201102111120211b21
001101011111110111a110111111111a00110110001110011001110011111110110110011011111110011111001a111101110110101111111011a1111111101111011101101201202220211222122b11
111111111111110110a111111101111a01110101111001111101101011111111110111111111101001111111111a011111011101110111111100a1111111110100111122211221222221201121211a21
110100110110110111a111101001111a10111111111001011111000111111110111001111101111111111111111a011110101101111111110011a1111111111111110110122122021210012121010a01
101111011111111111a011111101110a11110110110101110111111111110011111111011111111111111011011a100111110111100110111111a1111111111111111100221121112121221211112b10
111011011110101110a101011011111a11100110001110101111111101111111011111010101111101111010110a111111111011011111110110a1111111110110111111111110010111110111101a01
111101111101111111a111111011111a11111010111111111101111111110111011000111111110111111111111a110110111111111111111011a0111111010010110111101110111100100111111a11
111111101111111111a001111110011a01101111001110111110111110110011111110111100011111001111100a001111111010111111011110a1011111101111011111111111111110111111110a01
111001111110110001a101111110101a01100100101101010111111111101011111111111111111111111011111a001111011011101111101111a0111111111111011101101111101111111100011a11
111111011111101111a111110011111a00101111111111111111111111101110111011111111101111100001101a111011101011111011110111a1110110110011111101101110001011100101110a11
110011111011110111a111011011011a11111111101011111110111111101111111011011111111101110111011a111111111111011100100011a1101111111111011111100111111111111111111a11
111111011111011101a011110111001a11111000111011111100101101010111111110111111101001111011011a111110011110111110101111a1111010011111111111111111111111111101101a11
111111011111101111a111110110111a10101101111111111111111111111011011010001011111111111101110a100011011111100111101111a1110111111111110101001111111011111111010a11
111111111111011101a111111011011a01101001011011110111111111111111111111111100101111101000100a110111011011011101111111a1111111111111110011000001101111111111110a11
111101111111110010a111111011011a11111111110110111111111111011101011101101111011111011110101a110110111001111101011111a1111010101100001011011111110111101011011a00
011011111111111111a111111111111a10111010101111110111111111111110110111111011111011111011110a111110111011011111111101a1111111111111111111101111011111111011011a01
